20 10
9 3
0 0 0 0 0 0 0 0 0 0 0 0 0 0 0 0 0 0 0 0
0 0 0 0 1 2 2 2 2 2 2 2 2 2 3 0 0 0 0 0
0 0 0 0 4 5 5 5 5 5 5 5 5 5 6 0 0 0 0 0
0 0 0 0 4 5 5 5 5 5 5 5 5 5 6 0 7 8 0 0
0 0 0 0 4 5 5 5 5 5 5 5 5 5 6 0 9 10 0 0
0 0 0 0 11 12 5 5 5 5 5 5 5 13 14 0 0 0 0 0
0 0 0 0 0 4 5 5 5 5 5 5 5 6 0 0 0 0 0 0
0 0 0 0 0 4 5 5 5 5 5 5 5 6 0 0 0 0 0 0
0 0 0 0 0 4 5 5 5 5 5 5 5 6 0 0 0 0 0 0
0 0 0 0 0 11 15 15 15 15 15 15 15 14 0 0 0 0 0 0
