20 10
0 0
1 1 1 1 1 1 1 1 1 1 1 1 1 1 1 1 1 1 1 1
2 2 2 3 2 2 2 2 2 2 2 2 2 2 2 2 2 2 2 2
2 2 2 2 2 2 2 2 2 2 2 2 2 2 2 2 2 2 2 2
2 2 2 4 5 6 2 2 2 2 2 2 2 2 2 2 2 2 2 2
2 2 2 7 8 9 10 11 2 12 2 2 13 13 13 2 2 2 2 2
2 2 2 14 15 16 17 18 19 2 2 2 20 20 20 2 2 2 2 2
2 2 2 2 2 2 21 22 23 2 2 2 2 2 2 2 2 2 2 2
2 2 2 2 2 2 2 2 2 2 2 2 2 2 2 2 2 2 2 2
2 2 2 2 2 2 2 2 2 2 2 2 2 2 2 2 2 2 2 2
2 2 2 2 2 2 2 2 2 2 2 2 2 2 2 2 2 2 2 2
